NO ./assets/wall/brick-1l.png
SO ./assets/wall/brick-2l.png
WE ./assets/wall/brick-2d.png
EA ./assets/wall/brick-1d.png

C 238,245,255
F 210,227,200

1111111111111111111111111111111111111
1000000010000000100000000010000001001
1000000020000000100000000020000001001
1000000010000000100000000010000001111
1000000010000000200000000010000000011
1000000010000000100000000010000000001
1111211111112111111121111111112111111
1110000000000000000000000000000000001
1111000000000000000000000000000000111
1111110000000000000000000000111111111
1111111111111111000N00011111111111111
1111111111111111111111111111111111111
