NO ./assets/wall/brick-1l.png
SO ./assets/wall/brick-2l.png
WE ./assets/wall/brick-2d.png
EA ./assets/wall/brick-1d.png

C 173, 232, 244
F 58, 90, 64

        1111111111111111111111111
        10S0000000111001110000111
        1000000011100000010000001
        1111110000200000000010001
111111111110000001110011000010011
100000001000000001111111111111111
11000000000000011100000020001
11000010000111011100000010001
11112111111111011101010010001
11000000110101211100000010001
10000000000000001100000010001
111110000000000000000001111111111111
    11000000000000000011000000000001
      110000000000000001100010000001
   111112101111121111121100010001111
   100000111 1000001 100000000001
   10000001  1000001 100000000001
   11111111  1111111 111111111111
