NO ./assets/brick-1ld.png
SO ./assets/brick-2ld.png
WE ./assets/brick-2dd.png
EA ./assets/brick-1dd.png

C 238,245,255
F 210,227,200

111111111111
110000010001
10000N000001
110000000001
111111111111
