NO ./assets/brick-1l.png
SO ./assets/brick-2l.png
WE ./assets/brick-2d.png
EA ./assets/brick-1d.png

C 238,245,255
F 210,227,200

        1111111111111111111111111
        1000000000110000000000001
        1011000001110000000000001
        1001000000200000000000001
111111111011000001110000000000001
100000000011000001112111111111111
11112111111111011100000010001
11110111111111011100000010001
11110111111111011101010010001
1100000011010121110000002W001
10000000000000001100000010001
10000000000000001101010010001
10000000000000001101010010001
1100000111010101111101111000111
11110111 1110101 101111010001
11111111 1111111 111111111111
