NO ./assets/brick-1l.png
SO ./assets/brick-2l.png
WE ./assets/brick-2d.png
EA ./assets/brick-1d.png

C 238,245,255
F 210,227,200

11111111111111
11110W00000001
11000000000001
10000000000001
11111111111111