11111111
10101001
10100001
10101001
10000001
10100101
10001001
11111111
