111111111111111111111111
100000000000000000000001
100000000000000000000001
100000000000000000000001
100000111110000101010001
100000100010000000000001
100000100010000100010001
100000100010000000000001
100000110110000101010001
100000000000000000000001
100000000000000000000001
100000000000000000000001
100000000000000000000001
111111111111111000000001
110000000000001000000001
110000000000001000000001
110011111111001000000001
110010000000001000000001
110010000000001000000001
110011111111111000000001
110000000000000000000001
110000000000000000000001
111111111111111000000001
100000000000000000000001
100000000000000000000001
111111111111111111111111
